"a" = (/turf/closed/indestructible/void,/area/centcom/void)
"c" = (/turf/template_noop,/area/template_noop)
"e" = (/turf/open/floor/catwalk_floor,/area/centcom/void)
"f" = (/obj/effect/light_emitter/void,/turf/open/indestructible/void,/area/centcom/void)
"j" = (/obj/machinery/power/apc/auto_name/directional/south,/obj/machinery/power/terminal,/obj/structure/cable,/obj/effect/decal/cleanable/dirt,/obj/machinery/computer/camera_advanced/void_cam{dir = 1},/obj/machinery/button/door/indestructible{id = "voidhuyna"; name = "Hanger Bay Shutters"; pixel_x = -24},/turf/open/floor/catwalk_floor,/area/centcom/void)
"k" = (/obj/structure/cable,/obj/effect/decal/cleanable/dirt,/turf/open/floor/catwalk_floor,/area/centcom/void)
"l" = (/obj/machinery/power/smes/magical,/turf/open/floor/iron/smooth_edge,/area/centcom/void)
"n" = (/obj/machinery/camera/xray/void/directional/east,/turf/open/indestructible/void,/area/centcom/void)
"p" = (/obj/effect/landmark/voidspawn,/turf/open/indestructible/void,/area/centcom/void)
"q" = (/obj/effect/landmark/voidspawn,/turf/open/floor/cult,/area/centcom/void)
"r" = (/obj/item/camera/spooky,/turf/open/floor/catwalk_floor,/area/centcom/void)
"t" = (/obj/machinery/camera/xray/void/directional/south,/turf/open/indestructible/void,/area/centcom/void)
"z" = (/obj/machinery/door/poddoor{id = "voidhuyna"},/turf/open/floor/cult,/area/centcom/void)
"A" = (/obj/machinery/camera/xray/void/directional/north,/turf/open/indestructible/void,/area/centcom/void)
"B" = (/turf/closed/indestructible/cult,/area/centcom/void)
"E" = (/obj/machinery/camera/xray/void/directional/west,/turf/open/indestructible/void,/area/centcom/void)
"F" = (/obj/effect/landmark/voidspawn,/obj/machinery/camera/xray/void/directional/south,/turf/open/indestructible/void,/area/centcom/void)
"G" = (/obj/machinery/portable_atmospherics/canister/pluoxium,/turf/open/floor/cult,/area/centcom/void)
"I" = (/obj/structure/table/wood,/obj/item/paper/crumpled/bloody/ruins/the_outlet/final_regrets,/turf/open/floor/circuit/red,/area/centcom/void)
"K" = (/obj/structure/table/wood,/obj/item/trash/candy,/turf/open/floor/circuit/red,/area/centcom/void)
"L" = (/obj/machinery/power/terminal{dir = 1},/obj/structure/cable,/obj/effect/decal/cleanable/dirt,/turf/open/floor/catwalk_floor,/area/centcom/void)
"Q" = (/turf/open/floor/cult,/area/centcom/void)
"R" = (/obj/machinery/portable_atmospherics/canister/tritium,/turf/open/floor/cult,/area/centcom/void)
"V" = (/turf/open/indestructible/void,/area/centcom/void)

(1,1,1) = {"
aaaaaaaaaaaaaaaaaaaaaaaaaaaacccc
aVaApVVfVapVVVVVAapVVfVapapacccc
aVaaaaaVaaaVafaVVVVVaVVVVVVacccc
aVpVVVVVVVVpaVaaaaaVaaVaaVaacccc
aVaaaaaaaVaVaVpVVVaVaaVaVVpacccc
afVVVpVVVVaVaaaaaaaVapVaaVaBBBBB
aVaaaaVaaVaVaVVVVpVfaaaaVVnBlKIB
apVVVaVVVpVfaaaVaaaVVVVaVfVzLqQB
aaVaaaVaaaaVaVVtVVaVVVVVVVpzkreB
aaVVVafVpVVVaaaaaaaVaVaaaaaBjGRB
aaVaaaVaVaVVfVVpVVVpaVVVVpVBBBBB
afVapaVaVaaaVaaaaaaVaVaaaVaacccc
aEVaVVVapaVVVVVVpVVfaVVVVVaacccc
aaVaVaVaVapaaaaaVaaVaVaaaaaacccc
aaVVVaaaVaVVVVVaVVaVaVVVVfaacccc
aVpaVVVpftVVaapapVapaFaaapaacccc
aaaaaaaaaaaaaaaaaaaaaaaaaaaacccc
"}
